12DICHLORETHDEG-PWY	Degradation/Utilization/Assimilation
14DICHLORBENZDEG-PWY	Degradation/Utilization/Assimilation
1CMET2-PWY	Biosynthesis
2AMINOBENZDEG-PWY	Degradation/Utilization/Assimilation
2ASDEG-PWY	Degradation/Utilization/Assimilation
2OXOBUTYRATECAT-PWY	Degradation/Utilization/Assimilation
2PHENDEG-PWY	Degradation/Utilization/Assimilation
3-HYDROXYPHENYLACETATE-DEGRADATION-PWY	Degradation/Utilization/Assimilation
4-HYDROXYMANDELATE-DEGRADATION-PWY	Degradation/Utilization/Assimilation
4AMINOBUTMETAB-PWY	Degradation/Utilization/Assimilation
4TOLCARBDEG-PWY	Degradation/Utilization/Assimilation
6-HYDROXYCINEOLE-DEGRADATION-PWY	Degradation/Utilization/Assimilation
ACETATEUTIL-PWY	Degradation/Utilization/Assimilation
ACETOACETATE-DEG-PWY	Degradation/Utilization/Assimilation
AEROBACTINSYN-PWY	Biosynthesis
ALACAT2-PWY	Degradation/Utilization/Assimilation
ALADEG-PWY	Degradation/Utilization/Assimilation
ALANINE-SYN2-PWY	Biosynthesis
ALANINE-VALINESYN-PWY	Biosynthesis
ALKANEMONOX-PWY	Degradation/Utilization/Assimilation
ALL-CHORISMATE-PWY	Superpathways
AMMASSIM-PWY	Degradation/Utilization/Assimilation
AMMOXID-PWY	Degradation/Utilization/Assimilation
ANAEROFRUCAT-PWY	Generation of Precursor Metabolite and Energy
ANAGLYCOLYSIS-PWY	Generation of Precursor Metabolite and Energy
ANAPHENOXI-PWY	Degradation/Utilization/Assimilation
ARABCAT-PWY	Degradation/Utilization/Assimilation
ARG+POLYAMINE-SYN	Biosynthesis
ARG-GLU-PWY	Degradation/Utilization/Assimilation
ARG-PRO-PWY	Degradation/Utilization/Assimilation
ARGASEDEG-PWY	Degradation/Utilization/Assimilation
ARGDEG-III-PWY	Degradation/Utilization/Assimilation
ARGDEG-IV-PWY	Degradation/Utilization/Assimilation
ARGDEG-PWY	Degradation/Utilization/Assimilation
ARGDEG-V-PWY	Degradation/Utilization/Assimilation
ARGDEGRAD-PWY	Degradation/Utilization/Assimilation
ARGORNPROST-PWY	Degradation/Utilization/Assimilation
ARGSPECAT-PWY	Biosynthesis
ARGSYN-PWY	Biosynthesis
ARGSYNBSUB-PWY	Biosynthesis
ARO-PWY	Biosynthesis
ASPARAGINE-BIOSYNTHESIS	Biosynthesis
ASPARAGINE-DEG1-PWY	Degradation/Utilization/Assimilation
ASPARAGINESYN-PWY	Biosynthesis
ASPARTATE-DEG1-PWY	Degradation/Utilization/Assimilation
ASPARTATESYN-PWY	Biosynthesis
ASPASN-PWY	Biosynthesis
AST-PWY	Degradation/Utilization/Assimilation
BENZCOA-PWY	Degradation/Utilization/Assimilation
BETSYN-PWY	Biosynthesis
BGALACT-PWY	Degradation/Utilization/Assimilation
BIOTIN-BIOSYNTHESIS-PWY	Biosynthesis
BRANCHED-CHAIN-AA-SYN-PWY	Biosynthesis
BSUBPOLYAMSYN-PWY	Biosynthesis
CALVIN-PWY	Degradation/Utilization/Assimilation
CARNMET-PWY	Degradation/Utilization/Assimilation
CAROTENOID-PWY	Biosynthesis
CATECHOL-ORTHO-CLEAVAGE-PWY	Degradation/Utilization/Assimilation
CENTBENZCOA-PWY	Degradation/Utilization/Assimilation
CENTFERM-PWY	Generation of Precursor Metabolite and Energy
CHLOROPHYLL-SYN	Biosynthesis
CHOLINE-BETAINE-ANA-PWY	Degradation/Utilization/Assimilation
CITRULLINE-DEG-PWY	Degradation/Utilization/Assimilation
CO2FORM-PWY	Generation of Precursor Metabolite and Energy
COA-PWY	Biosynthesis
COBALSYN-PWY	Biosynthesis
CODH-PWY	Degradation/Utilization/Assimilation
COLANSYN-PWY	Biosynthesis
COMPLETE-ARO-PWY	Biosynthesis
CRNFORCAT-PWY	Degradation/Utilization/Assimilation
CYANCAT-PWY	Degradation/Utilization/Assimilation
CYCLOHEXANOL-OXIDATION-PWY	Degradation/Utilization/Assimilation
CYSTSYN-PWY	Biosynthesis
DAPLYSINESYN-PWY	Biosynthesis
DARABCAT-PWY	Degradation/Utilization/Assimilation
DARABCATK12-PWY	Degradation/Utilization/Assimilation
DARABITOLUTIL-PWY	Degradation/Utilization/Assimilation
DENITRIFICATION-PWY	Degradation/Utilization/Assimilation
DENOVOPURINE2-PWY	Biosynthesis
DESULFONATION-PWY	Degradation/Utilization/Assimilation
DETOX1-PWY	Detoxification
DETOX1-PWY-1	Detoxification
DHGLUCONATE-PYR-CAT-PWY	Degradation/Utilization/Assimilation
DISSULFRED-PWY	Degradation/Utilization/Assimilation
DTDPRHAMSYN-PWY	Biosynthesis
ECASYN-PWY	Biosynthesis
ENTBACSYN-PWY	Biosynthesis
ENTNER-DOUDOROFF-PWY	Degradation/Utilization/Assimilation
ETOH-ACETYLCOA-ANA-PWY	Degradation/Utilization/Assimilation
FAO-PWY	Degradation/Utilization/Assimilation
FASYN-ELONG-PWY	Biosynthesis
FASYN-INITIAL-PWY	Biosynthesis
FERMENTATION-PWY	Generation of Precursor Metabolite and Energy
FESULFOX-PWY	Degradation/Utilization/Assimilation
FLUORENE-DEG-9-ONE-PWY	Degradation/Utilization/Assimilation
FOLSYN-PWY	Biosynthesis
FORMASS-PWY	Degradation/Utilization/Assimilation
FUC-RHAMCAT-PWY	Superpathways
FUCCAT-PWY	Degradation/Utilization/Assimilation
GALACT-GLUCUROCAT-PWY	Superpathways
GALACTARDEG-PWY	Degradation/Utilization/Assimilation
GALACTCAT-PWY	Degradation/Utilization/Assimilation
GALACTITOLCAT-PWY	Degradation/Utilization/Assimilation
GALACTUROCAT-PWY	Degradation/Utilization/Assimilation
GALDEG-PWY	Degradation/Utilization/Assimilation
GALLATE-DEGRADATION-I-PWY	Degradation/Utilization/Assimilation
GALLATE-DEGRADATION-II-PWY	Degradation/Utilization/Assimilation
GAMMAHEXCHLORDEG-PWY	Degradation/Utilization/Assimilation
GDPRHAMSYN-PWY	Biosynthesis
GLCMANNANAUT-PWY	Degradation/Utilization/Assimilation
GLNSYN-PWY	Degradation/Utilization/Assimilation
GLUAMCAT-PWY	Degradation/Utilization/Assimilation
GLUCARDEG-PWY	Degradation/Utilization/Assimilation
GLUCARGALACTSUPER-PWY	Superpathways
GLUCONEO-PWY	Biosynthesis
GLUCONSUPER-PWY	Degradation/Utilization/Assimilation
GLUCOSE1PMETAB-PWY	Degradation/Utilization/Assimilation
GLUCUROCAT-PWY	Degradation/Utilization/Assimilation
GLUDEG-II-PWY	Generation of Precursor Metabolite and Energy
GLUT-REDOX-PWY	Biosynthesis
GLUTAMATE-DEG1-PWY	Degradation/Utilization/Assimilation
GLUTAMATE-SYN2-PWY	Biosynthesis
GLUTAMINDEG-PWY	Degradation/Utilization/Assimilation
GLUTAMINEFUM-PWY	Degradation/Utilization/Assimilation
GLUTATHIONESYN-PWY	Biosynthesis
GLUTDEG-PWY	Degradation/Utilization/Assimilation
GLUTORN-PWY	Biosynthesis
GLUTSYN-PWY	Biosynthesis
GLUTSYNIII-PWY	Biosynthesis
GLYCEROLMETAB-PWY	Degradation/Utilization/Assimilation
GLYCLEAV-PWY	Degradation/Utilization/Assimilation
GLYCOCAT-PWY	Degradation/Utilization/Assimilation
GLYCOGENSYNTH-PWY	Glycan Pathways
GLYCOL-GLYOXDEG-PWY	Degradation/Utilization/Assimilation
GLYCOLATEMET-PWY	Degradation/Utilization/Assimilation
GLYCOLYSIS	Generation of Precursor Metabolite and Energy
GLYCOLYSIS-E-D	Superpathways
GLYCOLYSIS-TCA-GLYOX-BYPASS	Superpathways
GLYOXDEG-PWY	Degradation/Utilization/Assimilation
GLYOXYLATE-BYPASS	Generation of Precursor Metabolite and Energy
GLYSYN-ALA-PWY	Biosynthesis
GLYSYN-PWY	Biosynthesis
GOLPDLCAT-PWY	Degradation/Utilization/Assimilation
HCAMHPDEG-PWY	Degradation/Utilization/Assimilation
HEME-BIOSYNTHESIS-II	Biosynthesis
HEMESYN2-PWY	Biosynthesis
HEXITOLDEGSUPER-PWY	Degradation/Utilization/Assimilation
HEXPPSYN-PWY	Biosynthesis
HISDEG-PWY	Degradation/Utilization/Assimilation
HISTDEG-PWY	Degradation/Utilization/Assimilation
HISTSYN-PWY	Biosynthesis
HOMOCYSDEGR-PWY	Degradation/Utilization/Assimilation
HOMOSER-METSYN-PWY	Biosynthesis
HOMOSER-THRESYN-PWY	Biosynthesis
HOMOSERSYN-PWY	Biosynthesis
HSERMETANA-PWY	Biosynthesis
IDNCAT-PWY	Degradation/Utilization/Assimilation
ILEUDEG-PWY	Degradation/Utilization/Assimilation
ILEUSYN-PWY	Biosynthesis
KDO-LIPASYN-PWY	Biosynthesis
KDO-NAGLIPASYN-PWY	Biosynthesis
KDOSYN-PWY	Biosynthesis
KETOGLUCONMET-PWY	Degradation/Utilization/Assimilation
LACTOSECAT-PWY	Degradation/Utilization/Assimilation
LACTOSEUTIL-PWY	Degradation/Utilization/Assimilation
LARABITOLUTIL-PWY	Degradation/Utilization/Assimilation
LCYSDEG-PWY	Degradation/Utilization/Assimilation
LEU-DEG2-PWY	Degradation/Utilization/Assimilation
LEUSYN-PWY	Biosynthesis
LIPA-CORESYN-PWY	Biosynthesis
LIPAS-PWY	Degradation/Utilization/Assimilation
LIPASYN-PWY	Degradation/Utilization/Assimilation
LPSSYN-PWY	Biosynthesis
LYXMET-PWY	Degradation/Utilization/Assimilation
M-CRESOL-DEGRADATION-PWY	Degradation/Utilization/Assimilation
MALTOSECAT-PWY	Degradation/Utilization/Assimilation
MANNCAT-PWY	Degradation/Utilization/Assimilation
MANNIDEG-PWY	Degradation/Utilization/Assimilation
MENAQUINONESYN-PWY	Biosynthesis
MET-SAM-PWY	Superpathways
METH-ACETATE-PWY	Generation of Precursor Metabolite and Energy
METHANOGENESIS-PWY	Generation of Precursor Metabolite and Energy
METHFORM-PWY	Generation of Precursor Metabolite and Energy
METHGLYUT-PWY	Degradation/Utilization/Assimilation
METHIONINE-DEG1-PWY	Degradation/Utilization/Assimilation
METHYLGALLATE-DEGRADATION-PWY	Degradation/Utilization/Assimilation
N2FIX-PWY	Degradation/Utilization/Assimilation
NAD-BIOSYNTHESIS-II	Biosynthesis
NAD-BIOSYNTHESIS-III	Biosynthesis
NADPHOS-DEPHOS-PWY	Biosynthesis
NADPHOS-DEPHOS-PWY-1	Biosynthesis
NADSYN-PWY	Biosynthesis
NAGLIPASYN-PWY	Biosynthesis
NONMEVIPP-PWY	Biosynthesis
NONOXIPENT-PWY	Generation of Precursor Metabolite and Energy
NOPALINEDEG-PWY	Degradation/Utilization/Assimilation
NPGLUCAT-PWY	Degradation/Utilization/Assimilation
OANTIGEN-PWY	Biosynthesis
OCTOPINEDEG-PWY	Degradation/Utilization/Assimilation
ORN-AMINOPENTANOATE-CAT-PWY	Biosynthesis
ORNARGDEG-PWY	Degradation/Utilization/Assimilation
ORNDEG-PWY	Degradation/Utilization/Assimilation
OXIDATIVEPENT-PWY	Generation of Precursor Metabolite and Energy
P101-PWY	Biosynthesis
P105-PWY	Generation of Precursor Metabolite and Energy
P108-PWY	Generation of Precursor Metabolite and Energy
P121-PWY	Biosynthesis
P122-PWY	Generation of Precursor Metabolite and Energy
P124-PWY	Generation of Precursor Metabolite and Energy
P125-PWY	Generation of Precursor Metabolite and Energy
P141-PWY	Degradation/Utilization/Assimilation
P142-PWY	Generation of Precursor Metabolite and Energy
P161-PWY	Generation of Precursor Metabolite and Energy
P162-PWY	Generation of Precursor Metabolite and Energy
P163-PWY	Generation of Precursor Metabolite and Energy
P164-PWY	Degradation/Utilization/Assimilation
P181-PWY	Degradation/Utilization/Assimilation
P183-PWY	Degradation/Utilization/Assimilation
P184-PWY	Degradation/Utilization/Assimilation
P2-PWY	Biosynthesis
P201-PWY	Degradation/Utilization/Assimilation
P203-PWY	Degradation/Utilization/Assimilation
P21-PWY	Generation of Precursor Metabolite and Energy
P221-PWY	Degradation/Utilization/Assimilation
P222-PWY	Degradation/Utilization/Assimilation
P224-PWY	Degradation/Utilization/Assimilation
P23-PWY	Degradation/Utilization/Assimilation
P241-PWY	Biosynthesis
P261-PWY	Biosynthesis
P281-PWY	Degradation/Utilization/Assimilation
P282-PWY	Generation of Precursor Metabolite and Energy
P283-PWY	Generation of Precursor Metabolite and Energy
P3-PWY	Degradation/Utilization/Assimilation
P301-PWY	Generation of Precursor Metabolite and Energy
P302-PWY	Degradation/Utilization/Assimilation
P303-PWY	Degradation/Utilization/Assimilation
P321-PWY	Degradation/Utilization/Assimilation
P341-PWY	Generation of Precursor Metabolite and Energy
P342-PWY	Degradation/Utilization/Assimilation
P343-PWY	Degradation/Utilization/Assimilation
P344-PWY	Degradation/Utilization/Assimilation
P345-PWY	Degradation/Utilization/Assimilation
P381-PWY	Superpathways
P4-PWY	Biosynthesis
P401-PWY	Degradation/Utilization/Assimilation
P41-PWY	Generation of Precursor Metabolite and Energy
P42-PWY	Degradation/Utilization/Assimilation
P421-PWY	Degradation/Utilization/Assimilation
P441-PWY	Degradation/Utilization/Assimilation
P461-PWY	Generation of Precursor Metabolite and Energy
P481-PWY	Degradation/Utilization/Assimilation
P482-PWY	Degradation/Utilization/Assimilation
P483-PWY	Degradation/Utilization/Assimilation
P541-PWY	Biosynthesis
P542-PWY	Degradation/Utilization/Assimilation
P561-PWY	Degradation/Utilization/Assimilation
P562-PWY	Degradation/Utilization/Assimilation
P581-PWY	Degradation/Utilization/Assimilation
P601-PWY	Degradation/Utilization/Assimilation
P621-PWY	Degradation/Utilization/Assimilation
P641-PWY	Detoxification
P661-PWY	Degradation/Utilization/Assimilation
P662-PWY	Degradation/Utilization/Assimilation
PANTO-PWY	Biosynthesis
PANTOSYN-PWY	Biosynthesis
PARATHION-DEGRADATION-PWY	Degradation/Utilization/Assimilation
PCEDEG-PWY	Degradation/Utilization/Assimilation
PCPDEG-PWY	Degradation/Utilization/Assimilation
PENTOSE-P-PWY	Generation of Precursor Metabolite and Energy
PEPTIDOGLYCANSYN-PWY	Biosynthesis
PHENOLDEG-PWY	Degradation/Utilization/Assimilation
PHENYLALANINE-DEG1-PWY	Degradation/Utilization/Assimilation
PHESYN	Biosynthesis
PHOSLIPSYN-PWY	Biosynthesis
PHOSPHONOTASE-PWY	Degradation/Utilization/Assimilation
PHOTOALL-PWY	Generation of Precursor Metabolite and Energy
PLPSAL-PWY	Biosynthesis
POLYAMINSYN3-PWY	Biosynthesis
POLYAMSYN-PWY	Biosynthesis
POLYISOPRENSYN-PWY	Biosynthesis
PPGPPMET-PWY	Biosynthesis
PROPFERM-PWY	Generation of Precursor Metabolite and Energy
PROPIONMET-PWY	Degradation/Utilization/Assimilation
PROSYN-PWY	Biosynthesis
PROTOCATECHUATE-ORTHO-CLEAVAGE-PWY	Degradation/Utilization/Assimilation
PROUT-PWY	Degradation/Utilization/Assimilation
PRPP-PWY	Superpathways
PUTDEG-PWY	Degradation/Utilization/Assimilation
PWY-1001	Biosynthesis
PWY-101	Generation of Precursor Metabolite and Energy
PWY-102	Degradation/Utilization/Assimilation
PWY-116	Degradation/Utilization/Assimilation
PWY-1164	Degradation/Utilization/Assimilation
PWY-1263	Degradation/Utilization/Assimilation
PWY-1264	Degradation/Utilization/Assimilation
PWY-1269	Biosynthesis
PWY-1281	Degradation/Utilization/Assimilation
PWY-1341	Degradation/Utilization/Assimilation
PWY-1361	Degradation/Utilization/Assimilation
PWY-1381	Degradation/Utilization/Assimilation
PWY-142	Degradation/Utilization/Assimilation
PWY-1422	Biosynthesis
PWY-1501	Degradation/Utilization/Assimilation
PWY-1541	Degradation/Utilization/Assimilation
PWY-1622	Degradation/Utilization/Assimilation
PWY-1641	Degradation/Utilization/Assimilation
PWY-1701	Degradation/Utilization/Assimilation
PWY-1722	Degradation/Utilization/Assimilation
PWY-1723	Degradation/Utilization/Assimilation
PWY-1781	Degradation/Utilization/Assimilation
PWY-1801	Degradation/Utilization/Assimilation
PWY-181	Generation of Precursor Metabolite and Energy
PWY-1861	Degradation/Utilization/Assimilation
PWY-1881	Generation of Precursor Metabolite and Energy
PWY-1882	Degradation/Utilization/Assimilation
PWY-2	Degradation/Utilization/Assimilation
PWY-2161	Biosynthesis
PWY-2201	Biosynthesis
PWY-2221	Degradation/Utilization/Assimilation
PWY-2242	Degradation/Utilization/Assimilation
PWY-2261	Detoxification
PWY-2301	Biosynthesis
PWY-2361	Degradation/Utilization/Assimilation
PWY-2381	Degradation/Utilization/Assimilation
PWY-2421	Degradation/Utilization/Assimilation
PWY-2503	Degradation/Utilization/Assimilation
PWY-2504	Degradation/Utilization/Assimilation
PWY-2601	Degradation/Utilization/Assimilation
PWY-2622	Biosynthesis
PWY-2661	Biosynthesis
PWY-2721	Degradation/Utilization/Assimilation
PWY-2722	Degradation/Utilization/Assimilation
PWY-283	Degradation/Utilization/Assimilation
PWY-2941	Biosynthesis
PWY-2942	Biosynthesis
PWY-3	Degradation/Utilization/Assimilation
PWY-3001	Biosynthesis
PWY-301	Degradation/Utilization/Assimilation
PWY-3081	Biosynthesis
PWY-3161	Biosynthesis
PWY-3162	Degradation/Utilization/Assimilation
PWY-3181	Degradation/Utilization/Assimilation
PWY-3461	Biosynthesis
PWY-3462	Biosynthesis
PWY-3561	Biosynthesis
PWY-3602	Degradation/Utilization/Assimilation
PWY-3621	Degradation/Utilization/Assimilation
PWY-3641	Degradation/Utilization/Assimilation
PWY-3661	Degradation/Utilization/Assimilation
PWY-3721	Degradation/Utilization/Assimilation
PWY-3722	Biosynthesis
PWY-3781	Generation of Precursor Metabolite and Energy
PWY-3801	Degradation/Utilization/Assimilation
PWY-3941	Biosynthesis
PWY-3982	Degradation/Utilization/Assimilation
PWY-4	Biosynthesis
PWY-40	Biosynthesis
PWY-4081	Biosynthesis
PWY-4101	Degradation/Utilization/Assimilation
PWY-4121	Biosynthesis
PWY-4181	Biosynthesis
PWY-4261	Degradation/Utilization/Assimilation
PWY-43	Biosynthesis
PWY-4341	Biosynthesis
PWY-4361	Biosynthesis
PWY-4381	Biosynthesis
PWY-4521	Generation of Precursor Metabolite and Energy
PWY-46	Biosynthesis
PWY-4601	Generation of Precursor Metabolite and Energy
PWY-4621	Detoxification
PWY-4722	Degradation/Utilization/Assimilation
PWY-4741	Degradation/Utilization/Assimilation
PWY-481	Degradation/Utilization/Assimilation
PWY-4821	Biosynthesis
PWY-4861	Biosynthesis
PWY-4921	Biosynthesis
PWY-4984	Degradation/Utilization/Assimilation
PWY-5005	Biosynthesis
PWY-5022	Generation of Precursor Metabolite and Energy
PWY-5024	Degradation/Utilization/Assimilation
PWY-5025	Biosynthesis
PWY-5026	Biosynthesis
PWY-5027	Biosynthesis
PWY-5028	Degradation/Utilization/Assimilation
PWY-5029	Biosynthesis
PWY-5033	Degradation/Utilization/Assimilation
PWY-5041	Biosynthesis
PWY-5046	Generation of Precursor Metabolite and Energy
PWY-5052	Biosynthesis
PWY-5053	Biosynthesis
PWY-5055	Degradation/Utilization/Assimilation
PWY-5057	Degradation/Utilization/Assimilation
PWY-5062	Degradation/Utilization/Assimilation
PWY-5063	Biosynthesis
PWY-5068	Biosynthesis
PWY-5074	Degradation/Utilization/Assimilation
PWY-5075	Degradation/Utilization/Assimilation
PWY-5080	Biosynthesis
PWY-5084	Generation of Precursor Metabolite and Energy
PWY-5086	Biosynthesis
PWY-5087	Degradation/Utilization/Assimilation
PWY-5088	Generation of Precursor Metabolite and Energy
PWY-5096	Generation of Precursor Metabolite and Energy
PWY-5097	Biosynthesis
PWY-5100	Generation of Precursor Metabolite and Energy
PWY-5101	Biosynthesis
PWY-5103	Biosynthesis
PWY-5104	Biosynthesis
PWY-5108	Biosynthesis
PWY-5120	Biosynthesis
PWY-5121	Biosynthesis
PWY-5122	Biosynthesis
PWY-5123	Biosynthesis
PWY-5130	Degradation/Utilization/Assimilation
PWY-5137	Degradation/Utilization/Assimilation
PWY-5142	Biosynthesis
PWY-5143	Biosynthesis
PWY-5148	Biosynthesis
PWY-5151	Degradation/Utilization/Assimilation
PWY-5154	Biosynthesis
PWY-5155	Biosynthesis
PWY-5159	Degradation/Utilization/Assimilation
PWY-5162	Degradation/Utilization/Assimilation
PWY-5163	Degradation/Utilization/Assimilation
PWY-5165	Degradation/Utilization/Assimilation
PWY-5169	Degradation/Utilization/Assimilation
PWY-5170	Degradation/Utilization/Assimilation
PWY-5171	Degradation/Utilization/Assimilation
PWY-5177	Degradation/Utilization/Assimilation
PWY-5178	Degradation/Utilization/Assimilation
PWY-5179	Degradation/Utilization/Assimilation
PWY-5180	Degradation/Utilization/Assimilation
PWY-5181	Degradation/Utilization/Assimilation
PWY-5182	Degradation/Utilization/Assimilation
PWY-5183	Degradation/Utilization/Assimilation
PWY-5184	Degradation/Utilization/Assimilation
PWY-5188	Biosynthesis
PWY-5189	Biosynthesis
PWY-5194	Biosynthesis
PWY-5196	Biosynthesis
PWY-5197	Generation of Precursor Metabolite and Energy
PWY-5198	Biosynthesis
PWY-5199	Biosynthesis
PWY-5207	Biosynthesis
PWY-5209	Generation of Precursor Metabolite and Energy
PWY-5247	Generation of Precursor Metabolite and Energy
PWY-5248	Generation of Precursor Metabolite and Energy
PWY-5250	Generation of Precursor Metabolite and Energy
PWY-5254	Biosynthesis
PWY-5257	Degradation/Utilization/Assimilation
PWY-5258	Generation of Precursor Metabolite and Energy
PWY-5259	Generation of Precursor Metabolite and Energy
PWY-5260	Generation of Precursor Metabolite and Energy
PWY-5261	Generation of Precursor Metabolite and Energy
PWY-5265	Biosynthesis
PWY-5266	Degradation/Utilization/Assimilation
PWY-5273	Degradation/Utilization/Assimilation
PWY-5274	Degradation/Utilization/Assimilation
PWY-5276	Degradation/Utilization/Assimilation
PWY-5277	Degradation/Utilization/Assimilation
PWY-5278	Degradation/Utilization/Assimilation
PWY-5279	Degradation/Utilization/Assimilation
PWY-5280	Degradation/Utilization/Assimilation
PWY-5283	Degradation/Utilization/Assimilation
PWY-5285	Degradation/Utilization/Assimilation
PWY-5288	Biosynthesis
PWY-5294	Degradation/Utilization/Assimilation
PWY-5296	Degradation/Utilization/Assimilation
PWY-5297	Biosynthesis
PWY-5298	Degradation/Utilization/Assimilation
PWY-5302	Degradation/Utilization/Assimilation
PWY-5303	Degradation/Utilization/Assimilation
PWY-5304	Degradation/Utilization/Assimilation
PWY-5306	Degradation/Utilization/Assimilation
PWY-5308	Degradation/Utilization/Assimilation
PWY-5314	Degradation/Utilization/Assimilation
PWY-5327	Degradation/Utilization/Assimilation
PWY-5331	Biosynthesis
PWY-5332	Degradation/Utilization/Assimilation
PWY-5335	Degradation/Utilization/Assimilation
PWY-5336	Degradation/Utilization/Assimilation
PWY-5340	Degradation/Utilization/Assimilation
PWY-5344	Biosynthesis
PWY-5345	Biosynthesis
PWY-5347	Biosynthesis
PWY-5350	Degradation/Utilization/Assimilation
PWY-5352	Degradation/Utilization/Assimilation
PWY-5358	Degradation/Utilization/Assimilation
PWY-5359	Degradation/Utilization/Assimilation
PWY-5360	Degradation/Utilization/Assimilation
PWY-5364	Degradation/Utilization/Assimilation
PWY-5366	Biosynthesis
PWY-5370	Degradation/Utilization/Assimilation
PWY-5372	Degradation/Utilization/Assimilation
PWY-5382	Generation of Precursor Metabolite and Energy
PWY-5384	Degradation/Utilization/Assimilation
PWY-5386	Degradation/Utilization/Assimilation
PWY-5389	Biosynthesis
PWY-5392	Degradation/Utilization/Assimilation
PWY-5415	Degradation/Utilization/Assimilation
PWY-5417	Degradation/Utilization/Assimilation
PWY-5418	Degradation/Utilization/Assimilation
PWY-5419	Degradation/Utilization/Assimilation
PWY-5420	Degradation/Utilization/Assimilation
PWY-5427	Degradation/Utilization/Assimilation
PWY-5428	Degradation/Utilization/Assimilation
PWY-5429	Degradation/Utilization/Assimilation
PWY-5430	Degradation/Utilization/Assimilation
PWY-5431	Degradation/Utilization/Assimilation
PWY-5436	Degradation/Utilization/Assimilation
PWY-5437	Degradation/Utilization/Assimilation
PWY-5443	Biosynthesis
PWY-5450	Degradation/Utilization/Assimilation
PWY-5453	Degradation/Utilization/Assimilation
PWY-5456	Degradation/Utilization/Assimilation
PWY-5459	Degradation/Utilization/Assimilation
PWY-5480	Generation of Precursor Metabolite and Energy
PWY-5481	Generation of Precursor Metabolite and Energy
PWY-5482	Generation of Precursor Metabolite and Energy
PWY-5483	Generation of Precursor Metabolite and Energy
PWY-5484	Generation of Precursor Metabolite and Energy
PWY-5485	Generation of Precursor Metabolite and Energy
PWY-5486	Generation of Precursor Metabolite and Energy
PWY-5487	Degradation/Utilization/Assimilation
PWY-5488	Degradation/Utilization/Assimilation
PWY-5489	Degradation/Utilization/Assimilation
PWY-5490	Degradation/Utilization/Assimilation
PWY-5491	Degradation/Utilization/Assimilation
PWY-5493	Degradation/Utilization/Assimilation
PWY-5494	Generation of Precursor Metabolite and Energy
PWY-5497	Degradation/Utilization/Assimilation
PWY-5499	Degradation/Utilization/Assimilation
PWY-5505	Biosynthesis
PWY-5507	Superpathways
PWY-5509	Biosynthesis
PWY-5512	Biosynthesis
PWY-5517	Degradation/Utilization/Assimilation
PWY-5519	Degradation/Utilization/Assimilation
PWY-5521	Biosynthesis
PWY-5523	Biosynthesis
PWY-5526	Biosynthesis
PWY-5529	Biosynthesis
PWY-5530	Biosynthesis
PWY-5531	Biosynthesis
PWY-5532	Degradation/Utilization/Assimilation
PWY-5533	Degradation/Utilization/Assimilation
PWY-5534	Degradation/Utilization/Assimilation
PWY-5535	Generation of Precursor Metabolite and Energy
PWY-5629	Biosynthesis
PWY-5631	Biosynthesis
PWY-5633	Biosynthesis
PWY-5634	Biosynthesis
PWY-5636	Degradation/Utilization/Assimilation
PWY-5637	Degradation/Utilization/Assimilation
PWY-5640	Degradation/Utilization/Assimilation
PWY-5641	Degradation/Utilization/Assimilation
PWY-5642	Degradation/Utilization/Assimilation
PWY-5643	Degradation/Utilization/Assimilation
PWY-5644	Degradation/Utilization/Assimilation
PWY-5645	Degradation/Utilization/Assimilation
PWY-5647	Degradation/Utilization/Assimilation
PWY-5648	Degradation/Utilization/Assimilation
PWY-5651	Degradation/Utilization/Assimilation
PWY-5653	Biosynthesis
PWY-5654	Degradation/Utilization/Assimilation
PWY-5655	Degradation/Utilization/Assimilation
PWY-5656	Biosynthesis
PWY-5658	Biosynthesis
PWY-5659	Biosynthesis
PWY-5661	Biosynthesis
PWY-5662	Biosynthesis
PWY-5663	Biosynthesis
PWY-5667	Biosynthesis
PWY-5668	Biosynthesis
PWY-5669	Biosynthesis
PWY-5670	Biosynthesis
PWY-5674	Degradation/Utilization/Assimilation
PWY-5675	Degradation/Utilization/Assimilation
PWY-5676	Generation of Precursor Metabolite and Energy
PWY-5677	Generation of Precursor Metabolite and Energy
PWY-5679	Biosynthesis
PWY-5686	Biosynthesis
PWY-5691	Degradation/Utilization/Assimilation
PWY-5694	Degradation/Utilization/Assimilation
PWY-5695	Degradation/Utilization/Assimilation
PWY-5697	Degradation/Utilization/Assimilation
PWY-5698	Degradation/Utilization/Assimilation
PWY-5703	Degradation/Utilization/Assimilation
PWY-5704	Degradation/Utilization/Assimilation
PWY-5705	Degradation/Utilization/Assimilation
PWY-5724	Degradation/Utilization/Assimilation
PWY-5726	Degradation/Utilization/Assimilation
PWY-5727	Degradation/Utilization/Assimilation
PWY-5731	Degradation/Utilization/Assimilation
PWY-5736	Degradation/Utilization/Assimilation
PWY-5737	Biosynthesis
PWY-5738	Biosynthesis
PWY-5739	Biosynthesis
PWY-5740	Biosynthesis
PWY-5741	Generation of Precursor Metabolite and Energy
PWY-5742	Degradation/Utilization/Assimilation
PWY-5743	Degradation/Utilization/Assimilation
PWY-5744	Degradation/Utilization/Assimilation
PWY-5747	Degradation/Utilization/Assimilation
PWY-5749	Degradation/Utilization/Assimilation
PWY-5751	Biosynthesis
PWY-5755	Biosynthesis
PWY-5757	Biosynthesis
PWY-5766	Degradation/Utilization/Assimilation
PWY-5770	Biosynthesis
PWY-5776	Biosynthesis
PWY-5782	Biosynthesis
PWY-5783	Biosynthesis
PWY-5785	Biosynthesis
PWY-5789	Degradation/Utilization/Assimilation
PWY-5794	Degradation/Utilization/Assimilation
PWY-5796	Biosynthesis
PWY-5805	Biosynthesis
PWY-5806	Biosynthesis
PWY-5807	Biosynthesis
PWY-5816	Biosynthesis
PWY-5817	Biosynthesis
PWY-5818	Biosynthesis
PWY-5823	Biosynthesis
PWY-5830	Biosynthesis
PWY-5831	Biosynthesis
PWY-5832	Biosynthesis
PWY-5833	Biosynthesis
PWY-5834	Biosynthesis
PWY-5837	Biosynthesis
PWY-5838	Biosynthesis
PWY-5839	Biosynthesis
PWY-5840	Biosynthesis
PWY-5844	Biosynthesis
PWY-5845	Biosynthesis
PWY-5849	Biosynthesis
PWY-5850	Biosynthesis
PWY-5851	Biosynthesis
PWY-5852	Biosynthesis
PWY-5853	Biosynthesis
PWY-5855	Biosynthesis
PWY-5856	Biosynthesis
PWY-5857	Biosynthesis
PWY-5860	Biosynthesis
PWY-5861	Biosynthesis
PWY-5862	Biosynthesis
PWY-5863	Biosynthesis
PWY-5875	Biosynthesis
PWY-5885	Biosynthesis
PWY-5886	Biosynthesis
PWY-5887	Biosynthesis
PWY-5888	Biosynthesis
PWY-5890	Biosynthesis
PWY-5891	Biosynthesis
PWY-5892	Biosynthesis
PWY-5893	Biosynthesis
PWY-5895	Biosynthesis
PWY-5896	Biosynthesis
PWY-5897	Biosynthesis
PWY-5898	Biosynthesis
PWY-5899	Biosynthesis
PWY-5901	Biosynthesis
PWY-5903	Biosynthesis
PWY-5907	Biosynthesis
PWY-5910	Biosynthesis
PWY-5913	Generation of Precursor Metabolite and Energy
PWY-5915	Biosynthesis
PWY-5917	Biosynthesis
PWY-5918	Biosynthesis
PWY-5920	Biosynthesis
PWY-5921	Biosynthesis
PWY-5922	Degradation/Utilization/Assimilation
PWY-5923	Degradation/Utilization/Assimilation
PWY-5924	Degradation/Utilization/Assimilation
PWY-5927	Degradation/Utilization/Assimilation
PWY-5929	Biosynthesis
PWY-5930	Biosynthesis
PWY-5935	Biosynthesis
PWY-5938	Generation of Precursor Metabolite and Energy
PWY-5939	Generation of Precursor Metabolite and Energy
PWY-5940	Biosynthesis
PWY-5941	Degradation/Utilization/Assimilation
PWY-5942	Biosynthesis
PWY-5943	Biosynthesis
PWY-5944	Biosynthesis
PWY-5945	Biosynthesis
PWY-5946	Biosynthesis
PWY-5947	Biosynthesis
PWY-5950	Biosynthesis
PWY-5951	Generation of Precursor Metabolite and Energy
PWY-5963	Biosynthesis
PWY-5964	Biosynthesis
PWY-5965	Biosynthesis
PWY-5966	Biosynthesis
PWY-5971	Biosynthesis
PWY-5972	Biosynthesis
PWY-5973	Biosynthesis
PWY-5978	Biosynthesis
PWY-5979	Biosynthesis
PWY-5981	Biosynthesis
PWY-5982	Degradation/Utilization/Assimilation
PWY-5983	Biosynthesis
PWY-5984	Biosynthesis
PWY-5985	Biosynthesis
PWY-5989	Biosynthesis
PWY-5993	Biosynthesis
PWY-5998	Biosynthesis
PWY-6003	Biosynthesis
PWY-6004	Biosynthesis
PWY-6011	Degradation/Utilization/Assimilation
PWY-6012	Biosynthesis
PWY-6012-1	Biosynthesis
PWY-6019	Degradation/Utilization/Assimilation
PWY-6021	Degradation/Utilization/Assimilation
PWY-6028	Degradation/Utilization/Assimilation
PWY-6038	Degradation/Utilization/Assimilation
PWY-6041	Degradation/Utilization/Assimilation
PWY-6043	Degradation/Utilization/Assimilation
PWY-6044	Degradation/Utilization/Assimilation
PWY-6045	Degradation/Utilization/Assimilation
PWY-6046	Degradation/Utilization/Assimilation
PWY-6047	Degradation/Utilization/Assimilation
PWY-6048	Degradation/Utilization/Assimilation
PWY-6049	Degradation/Utilization/Assimilation
PWY-6050	Degradation/Utilization/Assimilation
PWY-6052	Degradation/Utilization/Assimilation
PWY-6056	Degradation/Utilization/Assimilation
PWY-6057	Degradation/Utilization/Assimilation
PWY-6058	Degradation/Utilization/Assimilation
PWY-6059	Degradation/Utilization/Assimilation
PWY-6060	Degradation/Utilization/Assimilation
PWY-6069	Biosynthesis
PWY-6071	Degradation/Utilization/Assimilation
PWY-6072	Degradation/Utilization/Assimilation
PWY-6077	Degradation/Utilization/Assimilation
PWY-6079	Degradation/Utilization/Assimilation
PWY-6080	Degradation/Utilization/Assimilation
PWY-6081	Degradation/Utilization/Assimilation
PWY-6082	Glycan Pathways
PWY-6083	Degradation/Utilization/Assimilation
PWY-6084	Degradation/Utilization/Assimilation
PWY-6085	Degradation/Utilization/Assimilation
PWY-6086	Degradation/Utilization/Assimilation
PWY-6087	Degradation/Utilization/Assimilation
PWY-6088	Degradation/Utilization/Assimilation
PWY-6089	Degradation/Utilization/Assimilation
PWY-6090	Degradation/Utilization/Assimilation
PWY-6091	Degradation/Utilization/Assimilation
PWY-6093	Degradation/Utilization/Assimilation
PWY-6094	Degradation/Utilization/Assimilation
PWY-6095	Biosynthesis
PWY-6099	Degradation/Utilization/Assimilation
PWY-6102	Degradation/Utilization/Assimilation
PWY-6103	Degradation/Utilization/Assimilation
PWY-6104	Degradation/Utilization/Assimilation
PWY-6107	Degradation/Utilization/Assimilation
PWY-6113	Biosynthesis
PWY-6116	Biosynthesis
PWY-6120	Biosynthesis
PWY-6121	Biosynthesis
PWY-6122	Biosynthesis
PWY-6123	Biosynthesis
PWY-6125	Biosynthesis
PWY-6126	Biosynthesis
PWY-6128	Biosynthesis
PWY-6130	Generation of Precursor Metabolite and Energy
PWY-6131	Degradation/Utilization/Assimilation
PWY-6132	Biosynthesis
PWY-6139	Biosynthesis
PWY-6140	Biosynthesis
PWY-6141	Biosynthesis
PWY-6142	Biosynthesis
PWY-6143	Biosynthesis
PWY-6145	Biosynthesis
PWY-6146	Superpathways
PWY-6147	Biosynthesis
PWY-6148	Biosynthesis
PWY-6151	Biosynthesis
PWY-6153	Biosynthesis
PWY-6154	Biosynthesis
PWY-6157	Biosynthesis
PWY-6160	Biosynthesis
PWY-6163	Biosynthesis
PWY-6164	Biosynthesis
PWY-6165	Biosynthesis
PWY-6167	Biosynthesis
PWY-6173	Biosynthesis
PWY-6174	Biosynthesis
PWY-6176	Biosynthesis
PWY-6178	Degradation/Utilization/Assimilation
PWY-6182	Degradation/Utilization/Assimilation
PWY-6183	Degradation/Utilization/Assimilation
PWY-6184	Degradation/Utilization/Assimilation
PWY-6185	Degradation/Utilization/Assimilation
PWY-6190	Degradation/Utilization/Assimilation
PWY-6191	Degradation/Utilization/Assimilation
PWY-6192	Degradation/Utilization/Assimilation
PWY-6193	Degradation/Utilization/Assimilation
PWY-6196	Degradation/Utilization/Assimilation
PWY-6197	Degradation/Utilization/Assimilation
PWY-6200	Degradation/Utilization/Assimilation
PWY-621	Degradation/Utilization/Assimilation
PWY-6210	Degradation/Utilization/Assimilation
PWY-6214	Degradation/Utilization/Assimilation
PWY-6215	Degradation/Utilization/Assimilation
PWY-6216	Degradation/Utilization/Assimilation
PWY-6217	Degradation/Utilization/Assimilation
PWY-622	Glycan Pathways
PWY-6221	Degradation/Utilization/Assimilation
PWY-6223	Degradation/Utilization/Assimilation
PWY-6224	Degradation/Utilization/Assimilation
PWY-6228	Degradation/Utilization/Assimilation
PWY-6262	Biosynthesis
PWY-6263	Biosynthesis
PWY-6268	Biosynthesis
PWY-6269	Biosynthesis
PWY-6277	Biosynthesis
PWY-6279	Biosynthesis
PWY-6280	Biosynthesis
PWY-6281	Biosynthesis
PWY-6282	Biosynthesis
PWY-6284	Biosynthesis
PWY-6285	Biosynthesis
PWY-6286	Biosynthesis
PWY-6287	Biosynthesis
PWY-6288	Biosynthesis
PWY-6289	Biosynthesis
PWY-6291	Biosynthesis
PWY-6292	Biosynthesis
PWY-6294	Biosynthesis
PWY-63	Biosynthesis
PWY-6308	Biosynthesis
PWY-6314	Biosynthesis
PWY-6317	Degradation/Utilization/Assimilation
PWY-6321	Degradation/Utilization/Assimilation
PWY-6322	Biosynthesis
PWY-6324	Biosynthesis
PWY-6327	Generation of Precursor Metabolite and Energy
PWY-6328	Degradation/Utilization/Assimilation
PWY-6336	Degradation/Utilization/Assimilation
PWY-6338	Degradation/Utilization/Assimilation
PWY-6339	Degradation/Utilization/Assimilation
PWY-6340	Degradation/Utilization/Assimilation
PWY-6341	Degradation/Utilization/Assimilation
PWY-6343	Degradation/Utilization/Assimilation
PWY-6344	Degradation/Utilization/Assimilation
PWY-6345	Biosynthesis
PWY-6346	Biosynthesis
PWY-6348	Degradation/Utilization/Assimilation
PWY-6349	Biosynthesis
PWY-6350	Biosynthesis
PWY-6353	Degradation/Utilization/Assimilation
PWY-6373	Degradation/Utilization/Assimilation
PWY-6374	Biosynthesis
PWY-6375	Biosynthesis
PWY-6376	Biosynthesis
PWY-6378	Biosynthesis
PWY-6379	Biosynthesis
PWY-6381	Biosynthesis
PWY-6383	Biosynthesis
PWY-6385	Biosynthesis
PWY-6386	Biosynthesis
PWY-6387	Biosynthesis
PWY-6388	Degradation/Utilization/Assimilation
PWY-6389	Generation of Precursor Metabolite and Energy
PWY-6390	Generation of Precursor Metabolite and Energy
PWY-6391	Generation of Precursor Metabolite and Energy
PWY-6392	Generation of Precursor Metabolite and Energy
PWY-6395	Degradation/Utilization/Assimilation
PWY-6396	Generation of Precursor Metabolite and Energy
PWY-6397	Biosynthesis
PWY-6404	Biosynthesis
PWY-6406	Biosynthesis
PWY-6407	Biosynthesis
PWY-6408	Biosynthesis
PWY-6409	Biosynthesis
PWY-6412	Degradation/Utilization/Assimilation
PWY-6416	Degradation/Utilization/Assimilation
PWY-6419	Degradation/Utilization/Assimilation
PWY-6420	Biosynthesis
PWY-6421	Detoxification
PWY-6422	Degradation/Utilization/Assimilation
PWY-6426	Degradation/Utilization/Assimilation
PWY-6430	Degradation/Utilization/Assimilation
PWY-6454	Detoxification
PWY-6455	Detoxification
PWY-6456	Biosynthesis
PWY-6457	Biosynthesis
PWY-6458	Biosynthesis
PWY-6459	Biosynthesis
PWY-6461	Biosynthesis
PWY-6462	Biosynthesis
PWY-6463	Biosynthesis
PWY-6464	Degradation/Utilization/Assimilation
PWY-6466	Biosynthesis
PWY-6467	Biosynthesis
PWY-6470	Biosynthesis
PWY-6471	Biosynthesis
PWY-6475	Biosynthesis
PWY-6476	Biosynthesis
PWY-6478	Biosynthesis
PWY-6481	Biosynthesis
PWY-6482	Biosynthesis
PWY-6486	Degradation/Utilization/Assimilation
PWY-6497	Degradation/Utilization/Assimilation
PWY-6498	Biosynthesis
PWY-6499	Degradation/Utilization/Assimilation
PWY-6501	Degradation/Utilization/Assimilation
PWY-6502	Metabolic Clusters
PWY-6504	Degradation/Utilization/Assimilation
PWY-6505	Degradation/Utilization/Assimilation
PWY-6507	Degradation/Utilization/Assimilation
PWY-6509	Degradation/Utilization/Assimilation
PWY-6510	Degradation/Utilization/Assimilation
PWY-6511	Biosynthesis
PWY-6512	Generation of Precursor Metabolite and Energy
PWY-6516	Degradation/Utilization/Assimilation
PWY-6517	Degradation/Utilization/Assimilation
PWY-6518	Degradation/Utilization/Assimilation
PWY-6519	Biosynthesis
PWY-6523	Degradation/Utilization/Assimilation
PWY-6526	Degradation/Utilization/Assimilation
PWY-6529	Generation of Precursor Metabolite and Energy
PWY-6530	Generation of Precursor Metabolite and Energy
PWY-6532	Degradation/Utilization/Assimilation
PWY-6533	Degradation/Utilization/Assimilation
PWY-6534	Degradation/Utilization/Assimilation
PWY-6535	Degradation/Utilization/Assimilation
PWY-6536	Degradation/Utilization/Assimilation
PWY-6537	Degradation/Utilization/Assimilation
PWY-6538	Degradation/Utilization/Assimilation
PWY-6540	Biosynthesis
PWY-6543	Biosynthesis
PWY-6545	Biosynthesis
PWY-6550	Degradation/Utilization/Assimilation
PWY-6556	Degradation/Utilization/Assimilation
PWY-6559	Biosynthesis
PWY-6562	Biosynthesis
PWY-6565	Biosynthesis
PWY-6572	Degradation/Utilization/Assimilation
PWY-6574	Biosynthesis
PWY-6578	Biosynthesis
PWY-6580	Biosynthesis
PWY-6581	Biosynthesis
PWY-6583	Generation of Precursor Metabolite and Energy
PWY-6587	Generation of Precursor Metabolite and Energy
PWY-6588	Generation of Precursor Metabolite and Energy
PWY-6590	Generation of Precursor Metabolite and Energy
PWY-6591	Degradation/Utilization/Assimilation
PWY-6592	Degradation/Utilization/Assimilation
PWY-6593	Degradation/Utilization/Assimilation
PWY-6594	Generation of Precursor Metabolite and Energy
PWY-6598	Biosynthesis
PWY-6599	Biosynthesis
PWY-66	Biosynthesis
PWY-6604	Generation of Precursor Metabolite and Energy
PWY-6605	Biosynthesis
PWY-6608	Degradation/Utilization/Assimilation
PWY-6609	Biosynthesis
PWY-6610	Biosynthesis
PWY-6611	Biosynthesis
PWY-6612	Biosynthesis
PWY-6613	Biosynthesis
PWY-6614	Biosynthesis
PWY-6616	Degradation/Utilization/Assimilation
PWY-6617	Degradation/Utilization/Assimilation
PWY-6618	Biosynthesis
PWY-6619	Biosynthesis
PWY-6620	Biosynthesis
PWY-6622	Biosynthesis
PWY-6626	Biosynthesis
PWY-6627	Biosynthesis
PWY-6628	Biosynthesis
PWY-6629	Biosynthesis
PWY-6630	Biosynthesis
PWY-6632	Degradation/Utilization/Assimilation
PWY-6633	Degradation/Utilization/Assimilation
PWY-6634	Degradation/Utilization/Assimilation
PWY-6637	Degradation/Utilization/Assimilation
PWY-6638	Degradation/Utilization/Assimilation
PWY-6640	Degradation/Utilization/Assimilation
PWY-6641	Degradation/Utilization/Assimilation
PWY-6642	Degradation/Utilization/Assimilation
PWY-6643	Biosynthesis
PWY-6644	Biosynthesis
PWY-6646	Detoxification
PWY-6648	Biosynthesis
PWY-6649	Degradation/Utilization/Assimilation
PWY-6654	Biosynthesis
PWY-6655	Biosynthesis
PWY-6657	Biosynthesis
PWY-6658	Biosynthesis
PWY-6660	Biosynthesis
PWY-6661	Biosynthesis
PWY-6662	Biosynthesis
PWY-6664	Biosynthesis
PWY-6666	Biosynthesis
PWY-6670	Degradation/Utilization/Assimilation
PWY-6672	Degradation/Utilization/Assimilation
PWY-6675	Degradation/Utilization/Assimilation
PWY-6676	Degradation/Utilization/Assimilation
PWY-6677	Degradation/Utilization/Assimilation
PWY-6679	Biosynthesis
PWY-6682	Biosynthesis
PWY-6683	Degradation/Utilization/Assimilation
PWY-6685	Biosynthesis
PWY-6686	Biosynthesis
PWY-6687	Biosynthesis
PWY-6690	Degradation/Utilization/Assimilation
PWY-6692	Degradation/Utilization/Assimilation
PWY-6694	Degradation/Utilization/Assimilation
PWY-6695	Degradation/Utilization/Assimilation
PWY-6696	Degradation/Utilization/Assimilation
PWY-6697	Degradation/Utilization/Assimilation
PWY-6698	Degradation/Utilization/Assimilation
PWY-6700	Macromolecule Modification
PWY-6703	Biosynthesis
PWY-6707	Biosynthesis
PWY-6708	Biosynthesis
PWY-6711	Macromolecule Modification
PWY-6713	Degradation/Utilization/Assimilation
PWY-6714	Degradation/Utilization/Assimilation
PWY-6717	Degradation/Utilization/Assimilation
PWY-6718	Degradation/Utilization/Assimilation
PWY-6720	Biosynthesis
PWY-6721	Biosynthesis
PWY-6722	Biosynthesis
PWY-6728	Generation of Precursor Metabolite and Energy
PWY-6730	Biosynthesis
PWY-6731	Degradation/Utilization/Assimilation
PWY-6735	Degradation/Utilization/Assimilation
PWY-6737	Degradation/Utilization/Assimilation
PWY-6742	Degradation/Utilization/Assimilation
PWY-6744	Generation of Precursor Metabolite and Energy
PWY-6748	Degradation/Utilization/Assimilation
PWY-6749	Biosynthesis
PWY-6751	Generation of Precursor Metabolite and Energy
PWY-6753	Degradation/Utilization/Assimilation
PWY-6754	Degradation/Utilization/Assimilation
PWY-6756	Degradation/Utilization/Assimilation
PWY-6758	Generation of Precursor Metabolite and Energy
PWY-6759	Generation of Precursor Metabolite and Energy
PWY-6760	Degradation/Utilization/Assimilation
PWY-6765	Generation of Precursor Metabolite and Energy
PWY-6767	Biosynthesis
PWY-6771	Degradation/Utilization/Assimilation
PWY-6772	Generation of Precursor Metabolite and Energy
PWY-6773	Biosynthesis
PWY-6778	Degradation/Utilization/Assimilation
PWY-6780	Generation of Precursor Metabolite and Energy
PWY-6781	Degradation/Utilization/Assimilation
PWY-6784	Degradation/Utilization/Assimilation
PWY-6785	Generation of Precursor Metabolite and Energy
PWY-6789	Degradation/Utilization/Assimilation
PWY-6790	Degradation/Utilization/Assimilation
PWY-6794	Biosynthesis
PWY-6795	Biosynthesis
PWY-6797	Biosynthesis
PWY-6805	Degradation/Utilization/Assimilation
PWY-6806	Degradation/Utilization/Assimilation
PWY-6808	Biosynthesis
PWY-681	Degradation/Utilization/Assimilation
PWY-6813	Degradation/Utilization/Assimilation
PWY-6815	Degradation/Utilization/Assimilation
PWY-6816	Degradation/Utilization/Assimilation
PWY-6817	Degradation/Utilization/Assimilation
PWY-6818	Biosynthesis
PWY-6821	Degradation/Utilization/Assimilation
PWY-6822	Degradation/Utilization/Assimilation
PWY-6823	Biosynthesis
PWY-6825	Biosynthesis
PWY-6826	Biosynthesis
PWY-6827	Degradation/Utilization/Assimilation
PWY-6828	Detoxification
PWY-6830	Generation of Precursor Metabolite and Energy
PWY-6831	Biosynthesis
PWY-6832	Degradation/Utilization/Assimilation
PWY-6834	Biosynthesis
PWY-6853	Biosynthesis
PWY-6854	Biosynthesis
PWY-6855	Degradation/Utilization/Assimilation
PWY-6863	Generation of Precursor Metabolite and Energy
PWY-6871	Generation of Precursor Metabolite and Energy
PWY-6873	Generation of Precursor Metabolite and Energy
PWY-6876	Generation of Precursor Metabolite and Energy
PWY-6883	Generation of Precursor Metabolite and Energy
PWY-6886	Generation of Precursor Metabolite and Energy
PWY-6890	Biosynthesis
PWY-6891	Biosynthesis
PWY-6892	Biosynthesis
PWY-6893	Biosynthesis
PWY-6894	Biosynthesis
PWY-6895	Biosynthesis
PWY-6896	Biosynthesis
PWY-6897	Biosynthesis
PWY-6898	Biosynthesis
PWY-6899	Biosynthesis
PWY-6901	Degradation/Utilization/Assimilation
PWY-6902	Degradation/Utilization/Assimilation
PWY-6906	Degradation/Utilization/Assimilation
PWY-6907	Biosynthesis
PWY-6910	Biosynthesis
PWY-6915	Biosynthesis
PWY-6919	Biosynthesis
PWY-6923	Biosynthesis
PWY-6928	Degradation/Utilization/Assimilation
PWY-6932	Degradation/Utilization/Assimilation
PWY-6937	Degradation/Utilization/Assimilation
PWY-6938	Generation of Precursor Metabolite and Energy
PWY-6941	Degradation/Utilization/Assimilation
PWY-6942	Biosynthesis
PWY-6943	Degradation/Utilization/Assimilation
PWY-6944	Degradation/Utilization/Assimilation
PWY-6945	Degradation/Utilization/Assimilation
PWY-6946	Degradation/Utilization/Assimilation
PWY-6947	Degradation/Utilization/Assimilation
PWY-6948	Degradation/Utilization/Assimilation
PWY-6952	Degradation/Utilization/Assimilation
PWY-6953	Biosynthesis
PWY-6954	Degradation/Utilization/Assimilation
PWY-6955	Biosynthesis
PWY-6956	Degradation/Utilization/Assimilation
PWY-6957	Degradation/Utilization/Assimilation
PWY-6961	Degradation/Utilization/Assimilation
PWY-6962	Degradation/Utilization/Assimilation
PWY-6964	Degradation/Utilization/Assimilation
PWY-6965	Degradation/Utilization/Assimilation
PWY-6966	Degradation/Utilization/Assimilation
PWY-6967	Degradation/Utilization/Assimilation
PWY-6968	Degradation/Utilization/Assimilation
PWY-6969	Generation of Precursor Metabolite and Energy
PWY-6971	Biosynthesis
PWY-6972	Activation/Inactivation/Interconversion
PWY-6973	Biosynthesis
PWY-6974	Biosynthesis
PWY-6975	Biosynthesis
PWY-6976	Biosynthesis
PWY-6977	Biosynthesis
PWY-6978	Biosynthesis
PWY-6983	Biosynthesis
PWY-6984	Biosynthesis
PWY-6986	Degradation/Utilization/Assimilation
PWY-6987	Biosynthesis
PWY-6989	Degradation/Utilization/Assimilation
PWY-6992	Generation of Precursor Metabolite and Energy
PWY-6993	Degradation/Utilization/Assimilation
PWY-6994	Biosynthesis
PWY-6995	Degradation/Utilization/Assimilation
PWY-6996	Degradation/Utilization/Assimilation
PWY-6997	Detoxification
PWY-6998	Biosynthesis
PWY-6999	Degradation/Utilization/Assimilation
PWY-7000	Biosynthesis
PWY-7002	Degradation/Utilization/Assimilation
PWY-7003	Generation of Precursor Metabolite and Energy
PWY-7006	Degradation/Utilization/Assimilation
PWY-7007	Generation of Precursor Metabolite and Energy
PWY-7008	Degradation/Utilization/Assimilation
PWY-7009	Degradation/Utilization/Assimilation
PWY-701	Degradation/Utilization/Assimilation
PWY-7010	Degradation/Utilization/Assimilation
PWY-7011	Degradation/Utilization/Assimilation
PWY-7013	Generation of Precursor Metabolite and Energy
PWY-7014	Biosynthesis
PWY-7015	Biosynthesis
PWY-7016	Biosynthesis
PWY-7018	Biosynthesis
PWY-7019	Biosynthesis
PWY-7020	Biosynthesis
PWY-7021	Biosynthesis
PWY-7022	Biosynthesis
PWY-7024	Degradation/Utilization/Assimilation
PWY-7025	Biosynthesis
PWY-7026	Biosynthesis
PWY-7027	Biosynthesis
PWY-7028	Biosynthesis
PWY-7029	Biosynthesis
PWY-7031	Biosynthesis
PWY-7032	Biosynthesis
PWY-7036	Biosynthesis
PWY-7037	Biosynthesis
PWY-7040	Biosynthesis
PWY-7044	Degradation/Utilization/Assimilation
PWY-7045	Biosynthesis
PWY-7046	Degradation/Utilization/Assimilation
PWY-7050	Biosynthesis
PWY-7052	Biosynthesis
PWY-7054	Biosynthesis
PWY-7072	Biosynthesis
PWY-7077	Degradation/Utilization/Assimilation
PWY-7081	Degradation/Utilization/Assimilation
PWY-7082	Degradation/Utilization/Assimilation
PWY-7084	Degradation/Utilization/Assimilation
PWY-7085	Degradation/Utilization/Assimilation
PWY-7087	Biosynthesis
PWY-7090	Biosynthesis
PWY-7094	Biosynthesis
PWY-7096	Detoxification
PWY-7097	Degradation/Utilization/Assimilation
PWY-7098	Degradation/Utilization/Assimilation
PWY-7100	Biosynthesis
PWY-7102	Generation of Precursor Metabolite and Energy
PWY-7104	Biosynthesis
PWY-7106	Biosynthesis
PWY-7108	Biosynthesis
PWY-7109	Biosynthesis
PWY-7110	Biosynthesis
PWY-7111	Generation of Precursor Metabolite and Energy
PWY-7124	Biosynthesis
PWY-7126	Generation of Precursor Metabolite and Energy
PWY-7127	Biosynthesis
PWY-7128	Degradation/Utilization/Assimilation
PWY-7130	Degradation/Utilization/Assimilation
PWY-7131	Biosynthesis
PWY-7136	Degradation/Utilization/Assimilation
PWY-7147	Biosynthesis
PWY-7153	Biosynthesis
PWY-7159	Biosynthesis
PWY-7165	Biosynthesis
PWY-7167	Degradation/Utilization/Assimilation
PWY-7174	Biosynthesis
PWY-7175	Biosynthesis
PWY-7176	Biosynthesis
PWY-7177	Degradation/Utilization/Assimilation
PWY-7178	Generation of Precursor Metabolite and Energy
PWY-7179	Degradation/Utilization/Assimilation
PWY-7180	Degradation/Utilization/Assimilation
PWY-7181	Degradation/Utilization/Assimilation
PWY-7183	Biosynthesis
PWY-7184	Biosynthesis
PWY-7185	Degradation/Utilization/Assimilation
PWY-7187	Biosynthesis
PWY-7193	Biosynthesis
PWY-7194	Biosynthesis
PWY-7195	Degradation/Utilization/Assimilation
PWY-7196	Biosynthesis
PWY-7197	Biosynthesis
PWY-7198	Biosynthesis
PWY-7199	Biosynthesis
PWY-7200	Biosynthesis
PWY-7205	Biosynthesis
PWY-7206	Degradation/Utilization/Assimilation
PWY-7208	Biosynthesis
PWY-7209	Degradation/Utilization/Assimilation
PWY-721	Degradation/Utilization/Assimilation
PWY-7210	Biosynthesis
PWY-7211	Biosynthesis
PWY-7216	Biosynthesis
PWY-7218	Biosynthesis
PWY-7219	Biosynthesis
PWY-722	Degradation/Utilization/Assimilation
PWY-7220	Biosynthesis
PWY-7221	Biosynthesis
PWY-7222	Biosynthesis
PWY-7224	Biosynthesis
PWY-7226	Biosynthesis
PWY-7227	Biosynthesis
PWY-7228	Biosynthesis
PWY-7229	Biosynthesis
PWY-7234	Biosynthesis
PWY-7236	Biosynthesis
PWY-7237	Degradation/Utilization/Assimilation
PWY-7241	Degradation/Utilization/Assimilation
PWY-7242	Degradation/Utilization/Assimilation
PWY-7246	Degradation/Utilization/Assimilation
PWY-7247	Degradation/Utilization/Assimilation
PWY-7248	Degradation/Utilization/Assimilation
PWY-7250	Biosynthesis
PWY-7254	Generation of Precursor Metabolite and Energy
PWY-7255	Biosynthesis
PWY-7274	Biosynthesis
PWY-7275	Biosynthesis
PWY-7285	Macromolecule Modification
PWY-7286	Macromolecule Modification
PWY-7287	Biosynthesis
PWY-7289	Biosynthesis
PWY-7290	Biosynthesis
PWY-7294	Degradation/Utilization/Assimilation
PWY-7295	Degradation/Utilization/Assimilation
PWY-7301	Biosynthesis
PWY-7303	Biosynthesis
PWY-7304	Biosynthesis
PWY-7308	Degradation/Utilization/Assimilation
PWY-7309	Degradation/Utilization/Assimilation
PWY-7310	Degradation/Utilization/Assimilation
PWY-7312	Biosynthesis
PWY-7315	Biosynthesis
PWY-7316	Biosynthesis
PWY-7317	Biosynthesis
PWY-7318	Biosynthesis
PWY-7323	Biosynthesis
PWY-7328	Biosynthesis
PWY-7330	Biosynthesis
PWY-7331	Biosynthesis
PWY-7332	Biosynthesis
PWY-7333	Biosynthesis
PWY-7334	Biosynthesis
PWY-7335	Biosynthesis
PWY-7336	Biosynthesis
PWY-7343	Biosynthesis
PWY-7344	Biosynthesis
PWY-7346	Biosynthesis
PWY-7347	Biosynthesis
PWY-7352	Biosynthesis
PWY-7354	Biosynthesis
PWY-7355	Biosynthesis
PWY-7356	Biosynthesis
PWY-7367	Degradation/Utilization/Assimilation
PWY-7369	Biosynthesis
PWY-7371	Biosynthesis
PWY-7372	Biosynthesis
PWY-7373	Biosynthesis
PWY-7374	Biosynthesis
PWY-7376	Biosynthesis
PWY-7377	Biosynthesis
PWY-7378	Biosynthesis
PWY-7380	Biosynthesis
PWY-7385	Generation of Precursor Metabolite and Energy
PWY-7387	Degradation/Utilization/Assimilation
PWY-7391	Biosynthesis
PWY-7392	Biosynthesis
PWY-7393	Biosynthesis
PWY-7394	Degradation/Utilization/Assimilation
PWY-7395	Degradation/Utilization/Assimilation
PWY-7396	Generation of Precursor Metabolite and Energy
PWY-7398	Biosynthesis
PWY-7399	Degradation/Utilization/Assimilation
PWY-7400	Biosynthesis
PWY-7401	Generation of Precursor Metabolite and Energy
PWY-7402	Generation of Precursor Metabolite and Energy
PWY-7403	Degradation/Utilization/Assimilation
PWY-7405	Biosynthesis
PWY-7407	Biosynthesis
PWY-741	Degradation/Utilization/Assimilation
PWY-7412	Biosynthesis
PWY-7413	Biosynthesis
PWY-7414	Biosynthesis
PWY-7415	Biosynthesis
PWY-7419	Biosynthesis
PWY-7421	Biosynthesis
PWY-7422	Biosynthesis
PWY-7425	Degradation/Utilization/Assimilation
PWY-7428	Degradation/Utilization/Assimilation
PWY-7429	Generation of Precursor Metabolite and Energy
PWY-743	Degradation/Utilization/Assimilation
PWY-7431	Degradation/Utilization/Assimilation
PWY-7438	Biosynthesis
PWY-7439	Biosynthesis
PWY-7440	Biosynthesis
PWY-7441	Biosynthesis
PWY-7446	Degradation/Utilization/Assimilation
PWY-7447	Degradation/Utilization/Assimilation
PWY-7456	Degradation/Utilization/Assimilation
PWY-7457	Degradation/Utilization/Assimilation
PWY-7459	Degradation/Utilization/Assimilation
PWY-7462	Degradation/Utilization/Assimilation
PWY-7465	Degradation/Utilization/Assimilation
PWY-7467	Biosynthesis
PWY-7469	Degradation/Utilization/Assimilation
PWY-7470	Biosynthesis
PWY-7471	Degradation/Utilization/Assimilation
PWY-7472	Degradation/Utilization/Assimilation
PWY-7480	Degradation/Utilization/Assimilation
PWY-7482	Biosynthesis
PWY-7483	Biosynthesis
PWY-7485	Biosynthesis
PWY-7496	Degradation/Utilization/Assimilation
PWY-7509	Biosynthesis
PWY-7510	Biosynthesis
PWY-7512	Degradation/Utilization/Assimilation
PWY-7513	Biosynthesis
PWY-7514	Degradation/Utilization/Assimilation
PWY-7515	Degradation/Utilization/Assimilation
PWY-7516	Degradation/Utilization/Assimilation
PWY-7521	Degradation/Utilization/Assimilation
PWY-7524	Biosynthesis
PWY-7527	Biosynthesis
PWY-7528	Biosynthesis
PWY-7529	Biosynthesis
PWY-7530	Biosynthesis
PWY-7531	Biosynthesis
PWY-7536	Biosynthesis
PWY-7539	Biosynthesis
PWY-7541	Generation of Precursor Metabolite and Energy
PWY-7544	Generation of Precursor Metabolite and Energy
PWY-7545	Generation of Precursor Metabolite and Energy
PWY-7547	Biosynthesis
PWY-7548	Biosynthesis
PWY-7552	Biosynthesis
PWY-7554	Biosynthesis
PWY-7557	Degradation/Utilization/Assimilation
PWY-7560	Biosynthesis
PWY-7562	Degradation/Utilization/Assimilation
PWY-7564	Biosynthesis
PWY-7566	Degradation/Utilization/Assimilation
PWY-7568	Degradation/Utilization/Assimilation
PWY-7569	Biosynthesis
PWY-7570	Biosynthesis
PWY-7573	Biosynthesis
PWY-7574	Degradation/Utilization/Assimilation
PWY-7575	Biosynthesis
PWY-7576	Degradation/Utilization/Assimilation
PWY-7578	Biosynthesis
PWY-7579	Biosynthesis
PWY-7580	Biosynthesis
PWY-7581	Degradation/Utilization/Assimilation
PWY-7582	Degradation/Utilization/Assimilation
PWY-7583	Biosynthesis
PWY-7585	Biosynthesis
PWY-7586	Degradation/Utilization/Assimilation
PWY-7587	Biosynthesis
PWY-7588	Biosynthesis
PWY-7589	Biosynthesis
PWY-7591	Biosynthesis
PWY-7593	Biosynthesis
PWY-7594	Biosynthesis
PWY-7595	Biosynthesis
PWY-7596	Biosynthesis
PWY-7598	Biosynthesis
PWY-761	Biosynthesis
PWY-7610	Biosynthesis
PWY-7613	Biosynthesis
PWY-7616	Degradation/Utilization/Assimilation
PWY-7620	Degradation/Utilization/Assimilation
PWY-7621	Biosynthesis
PWY-7622	Biosynthesis
PWY-7623	Biosynthesis
PWY-7624	Biosynthesis
PWY-7626	Biosynthesis
PWY-7627	Degradation/Utilization/Assimilation
PWY-7628	Degradation/Utilization/Assimilation
PWY-7637	Biosynthesis
PWY-7638	Biosynthesis
PWY-7639	Biosynthesis
PWY-7641	Biosynthesis
PWY-7644	Degradation/Utilization/Assimilation
PWY-7645	Degradation/Utilization/Assimilation
PWY-7646	Degradation/Utilization/Assimilation
PWY-7647	Degradation/Utilization/Assimilation
PWY-7651	Degradation/Utilization/Assimilation
PWY-7652	Degradation/Utilization/Assimilation
PWY-7657	Biosynthesis
PWY-7658	Biosynthesis
PWY-7661	Biosynthesis
PWY-7663	Biosynthesis
PWY-7664	Biosynthesis
PWY-7666	Biosynthesis
PWY-7671	Biosynthesis
PWY-7674	Biosynthesis
PWY-7675	Biosynthesis
PWY-7676	Biosynthesis
PWY-7677	Biosynthesis
PWY-804	Generation of Precursor Metabolite and Energy
PWY-81	Degradation/Utilization/Assimilation
PWY-822	Biosynthesis
PWY-841	Biosynthesis
PWY-881	Biosynthesis
PWY-922	Biosynthesis
PWY-981	Biosynthesis
PWY0-1021	Biosynthesis
PWY0-1061	Biosynthesis
PWY0-1182	Degradation/Utilization/Assimilation
PWY0-1221	Degradation/Utilization/Assimilation
PWY0-1241	Biosynthesis
PWY0-1261	Degradation/Utilization/Assimilation
PWY0-1264	Biosynthesis
PWY0-1275	Biosynthesis
PWY0-1277	Degradation/Utilization/Assimilation
PWY0-1280	Degradation/Utilization/Assimilation
PWY0-1295	Degradation/Utilization/Assimilation
PWY0-1296	Degradation/Utilization/Assimilation
PWY0-1297	Degradation/Utilization/Assimilation
PWY0-1298	Degradation/Utilization/Assimilation
PWY0-1299	Detoxification
PWY0-1300	Degradation/Utilization/Assimilation
PWY0-1301	Degradation/Utilization/Assimilation
PWY0-1303	Biosynthesis
PWY0-1305	Degradation/Utilization/Assimilation
PWY0-1306	Degradation/Utilization/Assimilation
PWY0-1309	Degradation/Utilization/Assimilation
PWY0-1312	Generation of Precursor Metabolite and Energy
PWY0-1313	Degradation/Utilization/Assimilation
PWY0-1314	Degradation/Utilization/Assimilation
PWY0-1315	Degradation/Utilization/Assimilation
PWY0-1317	Degradation/Utilization/Assimilation
PWY0-1319	Biosynthesis
PWY0-1321	Degradation/Utilization/Assimilation
PWY0-1324	Degradation/Utilization/Assimilation
PWY0-1325	Biosynthesis
PWY0-1329	Generation of Precursor Metabolite and Energy
PWY0-1334	Generation of Precursor Metabolite and Energy
PWY0-1335	Generation of Precursor Metabolite and Energy
PWY0-1336	Generation of Precursor Metabolite and Energy
PWY0-1337	Degradation/Utilization/Assimilation
PWY0-1338	Biosynthesis
PWY0-1347	Generation of Precursor Metabolite and Energy
PWY0-1348	Generation of Precursor Metabolite and Energy
PWY0-1352	Degradation/Utilization/Assimilation
PWY0-1353	Generation of Precursor Metabolite and Energy
PWY0-1355	Generation of Precursor Metabolite and Energy
PWY0-1356	Generation of Precursor Metabolite and Energy
PWY0-1391	Degradation/Utilization/Assimilation
PWY0-1415	Biosynthesis
PWY0-1433	Biosynthesis
PWY0-1465	Degradation/Utilization/Assimilation
PWY0-1466	Degradation/Utilization/Assimilation
PWY0-1471	Degradation/Utilization/Assimilation
PWY0-1477	Degradation/Utilization/Assimilation
PWY0-1479	Macromolecule Modification
PWY0-1507	Biosynthesis
PWY0-1517	Generation of Precursor Metabolite and Energy
PWY0-1527	Degradation/Utilization/Assimilation
PWY0-1533	Degradation/Utilization/Assimilation
PWY0-1534	Degradation/Utilization/Assimilation
PWY0-1535	Degradation/Utilization/Assimilation
PWY0-1544	Generation of Precursor Metabolite and Energy
PWY0-1546	Degradation/Utilization/Assimilation
PWY0-1554	Macromolecule Modification
PWY0-1561	Generation of Precursor Metabolite and Energy
PWY0-1565	Generation of Precursor Metabolite and Energy
PWY0-1567	Generation of Precursor Metabolite and Energy
PWY0-1568	Generation of Precursor Metabolite and Energy
PWY0-1569	Degradation/Utilization/Assimilation
PWY0-1576	Generation of Precursor Metabolite and Energy
PWY0-1577	Generation of Precursor Metabolite and Energy
PWY0-1578	Generation of Precursor Metabolite and Energy
PWY0-1581	Degradation/Utilization/Assimilation
PWY0-1582	Generation of Precursor Metabolite and Energy
PWY0-1584	Degradation/Utilization/Assimilation
PWY0-1586	Biosynthesis
PWY0-162	Biosynthesis
PWY0-166	Biosynthesis
PWY0-301	Degradation/Utilization/Assimilation
PWY0-321	Degradation/Utilization/Assimilation
PWY0-381	Degradation/Utilization/Assimilation
PWY0-41	Degradation/Utilization/Assimilation
PWY0-42	Degradation/Utilization/Assimilation
PWY0-43	Degradation/Utilization/Assimilation
PWY0-44	Degradation/Utilization/Assimilation
PWY0-461	Degradation/Utilization/Assimilation
PWY0-501	Biosynthesis
PWY0-521	Degradation/Utilization/Assimilation
PWY0-522	Biosynthesis
PWY0-541	Biosynthesis
PWY0-662	Biosynthesis
PWY0-781	Superpathways
PWY0-823	Degradation/Utilization/Assimilation
PWY0-845	Biosynthesis
PWY0-862	Biosynthesis
PWY0-901	Biosynthesis
PWY0-981	Degradation/Utilization/Assimilation
PWY1-2	Degradation/Utilization/Assimilation
PWY1-3	Biosynthesis
PWY1A0-6325	Biosynthesis
PWY1G-0	Biosynthesis
PWY1G-1	Detoxification
PWY1G-126	Biosynthesis
PWY1G-170	Degradation/Utilization/Assimilation
PWY3DJ-11281	Biosynthesis
PWY3O-246	Degradation/Utilization/Assimilation
PWY3O-4106	Biosynthesis
PWY3O-440	Generation of Precursor Metabolite and Energy
PWY3O-450	Biosynthesis
PWY490-3	Degradation/Utilization/Assimilation
PWY490-4	Biosynthesis
PWY4FS-7	Biosynthesis
PWY4FS-8	Biosynthesis
PWY5F9-12	Degradation/Utilization/Assimilation
PWY5F9-3233	Degradation/Utilization/Assimilation
PWY66-21	Degradation/Utilization/Assimilation
PWY8J2-1	Biosynthesis
PWY8J2-20	Biosynthesis
PWY8J2-22	Biosynthesis
PWYG-321	Biosynthesis
PWYQT-4427	Biosynthesis
PWYQT-4429	Degradation/Utilization/Assimilation
PYRIDNUCSAL-PWY	Biosynthesis
PYRIDNUCSYN-PWY	Biosynthesis
PYRIDOXSYN-PWY	Biosynthesis
PYRUVDEHYD-PWY	Generation of Precursor Metabolite and Energy
QUINATEDEG-PWY	Degradation/Utilization/Assimilation
REDCITCYC	Generation of Precursor Metabolite and Energy
RHAMCAT-PWY	Degradation/Utilization/Assimilation
RIBITOLUTIL-PWY	Degradation/Utilization/Assimilation
RIBOKIN-PWY	Degradation/Utilization/Assimilation
RIBOSYN2-PWY	Biosynthesis
RUMP-PWY	Degradation/Utilization/Assimilation
SALVADEHYPOX-PWY	Degradation/Utilization/Assimilation
SALVPURINE2-PWY	Biosynthesis
SAM-PWY	Biosynthesis
SER-GLYSYN-PWY	Biosynthesis
SERDEG-PWY	Degradation/Utilization/Assimilation
SERSYN-PWY	Biosynthesis
SHIKIMATEDEG-PWY	Degradation/Utilization/Assimilation
SO4ASSIM-PWY	Degradation/Utilization/Assimilation
SORBDEG-PWY	Degradation/Utilization/Assimilation
SUCROSEUTIL2-PWY	Degradation/Utilization/Assimilation
SUCSYN-PWY	Biosynthesis
SUCUTIL-PWY	Degradation/Utilization/Assimilation
SULFATE-CYS-PWY	Degradation/Utilization/Assimilation
SULFMETII-PWY	Degradation/Utilization/Assimilation
SULFUROX-PWY	Degradation/Utilization/Assimilation
TAURINEDEG-PWY	Degradation/Utilization/Assimilation
TCA	Generation of Precursor Metabolite and Energy
TCA-GLYOX-BYPASS	Generation of Precursor Metabolite and Energy
TEICHOICACID-PWY	Biosynthesis
THIOREDOX-PWY	Biosynthesis
THIOSULFOX-PWY	Degradation/Utilization/Assimilation
THISYN-PWY	Biosynthesis
THRDLCTCAT-PWY	Degradation/Utilization/Assimilation
THREOCAT-PWY	Degradation/Utilization/Assimilation
THREONINE-DEG2-PWY	Degradation/Utilization/Assimilation
THRESYN-PWY	Biosynthesis
TOLSULFDEG-PWY	Degradation/Utilization/Assimilation
TOLUENE-DEG-2-OH-PWY	Degradation/Utilization/Assimilation
TOLUENE-DEG-3-OH-PWY	Degradation/Utilization/Assimilation
TOLUENE-DEG-4-OH-PWY	Degradation/Utilization/Assimilation
TOLUENE-DEG-CATECHOL-PWY	Degradation/Utilization/Assimilation
TOLUENE-DEG-DIOL-PWY	Degradation/Utilization/Assimilation
TREDEGLOW-PWY	Degradation/Utilization/Assimilation
TREHALOSESYN-PWY	Biosynthesis
TRESYN-PWY	Biosynthesis
TRNA-CHARGING-PWY	Biosynthesis
TRPCAT-PWY	Degradation/Utilization/Assimilation
TRPIAACAT-PWY	Biosynthesis
TRPKYNCAT-PWY	Degradation/Utilization/Assimilation
TRPSYN-PWY	Biosynthesis
TRYPDEG-PWY	Degradation/Utilization/Assimilation
TYRFUMCAT-PWY	Degradation/Utilization/Assimilation
TYRSYN	Biosynthesis
UBISYN-PWY	Biosynthesis
UDPNAGSYN-PWY	Biosynthesis
VALDEG-PWY	Degradation/Utilization/Assimilation
VALSYN-PWY	Biosynthesis
XYLCAT-PWY	Degradation/Utilization/Assimilation